WE ./path_to_the_west_texture
NO ./path_to_the_north_texture
SO ./path_to_the_south_texture
EA ./path_to_the_east_texture

F 000,000,000
C 225,255,254

111111111111111111111111111111
11S010000000000000010000110011
110011111110000000010110000011
110010000000000000000000000011
110010110010001110010001100011
110010000010001110010001100011
110010110010001110010000000011
110010000010001111110000000011
110010110010001110000000000111
110011111111101111111110000011
110000000000000000001000000011
111111001111111111111010000011
110101001000000000000011111011
110101001111111100000010001011
110000000000000100000010000011
111111111111111111111111111111
111111111111111111111111111111