WE              ./textures/xpm/004_basecolor.xpm
NO ./textures/xpm/004_roughness.xpm
SO  ./textures/xpm/005_ambientocclusion_0.xpm
EA./textures/xpm/005_basecolor_0.xpm

F 196,164,132
C 135,206,235

111111111111111111111111111111
              110000000000000000000000000011
111111111111111000000000000011
110000000000000000000000000011
11000000000000011111111111111
11000000N000000011111111
110000000000000011111000000011
110000000100000011111000000011
110000000000000011111000000011
110000000100001111111100000011
110000000000000001111000000111
110000000000001111111100000011
110000000000000000000000000011
111111111111111111111111111111