WE./textures/xpm/colorstone.xpm
NO./textures/xpm/greystone.xpm
SO./textures/xpm/mossy.xpm
EA./textures/xpm/wood.xpm

F 196, 124, 036
C 0, 255, 255

111111111111111111111111111111
110000000000000000000000000011
111111111111111000000000000011
110000000000000000000000000011
110000000000000111111111111111
11000000N000000011111111111111
110000000000000011111000000011
110000000100000011111000000011
110000000000000011111000000011
110000000100001111111100000011
110000000000000001111000000111
110000000000001111111100000011
110000000000000000000000000011
111111111111111111111111111111