WE./textures/eagle.xpm
NO./textures/purplestone.xpm
SO./textures/red.xpm
EA./textures/greystone.xpm

F 0,0,0
C 255,0,0

1111111
1000001
1N00001
1111111