WE./textures/colorstone.xpm
NO./textures/greystone.xpm
SO./textures/mossy.xpm
EA./textures/wood.xpm

F 144,238,144
C 225,255,254






1111111

1000001
1N00001
1111111